........^............
........^............
........^...^........
........^...^........
........^...^........
............^........
............^........

7 5 15 5 32
