........^............
...oo...^ooooooo.....
...oo...^oo^.........
........^oo^.........
........^oo^.........
....ooooooo^.........
...........^.........