........^............
........^ooo.........
........^oo^.........
........^oo^.........
........^oo^.........
........ooo^.........
...........^.........
7 5 15 5 1.0
