........^............
........^............
........^..^.........
........^..^.........
........^..^.........
...........^.........
...........^.........
7 5 15 5 1.0
