.^.........^^^^......
.^.........^..^......
.^....^^^^.^..^.^^^^.
.^....^..^.^..^.^..^.
.^^^^.^..^.^^^^.^^^^.
......^..^......^....
......^^^^......^....

5 0 5 6 0.1
10 0 10 6 0.1
15 0 15 6 0.1
