..........^..........
.......^oo^..........
.......^oo^..........
.......^oo^..........
.......^^^^..........
.......^ooooooo......
.......^.............

5 6 5 1 1.0
6 1 6 6 1.0